11111111111111111111111111111111
10000000000000000000000000000001
10000000000000000000000000000001
10011111111111111111111111111001
10010000000000000000000000001001
10010000000000000000000000001001
10010011111111111111111111001001
10010010000000000000000001001001
10010010000000000000000001001001
10010010011111111111110001001001
10010010010000000000010001001001
10010010010000000000010001001001
10010010010000000000010001001001
10010010011111001111110001001001
10010010000000000000000001001001
10010010000000000000000001001001
10010011111111111111111111001001
10010000000000000000000000001001
10010000000000000000000000001001
10011111111111111111111111111001
10000000000000000000000000000001
10000000000000000000000000000001
11111111111111111111111111111111